Helios Systems - Recovery Assignment

Vessel ID: T-7366D

Status: Missing

Crew: Unresponsive

Primary Objective: Investigate vessel and recover assigned cargo.

Secondary Objective: Assess cause of communication failure.

No distress signal was successfully recorded.

Last known position has been stabilised for boarding.

You are authorised to proceed.

The airlock cycles open with a dull, mechanical thud.

Cold air spills out to meet you.

Beyond it, the ship is dark.

No movement. No sound.

Just the faint hum of systems running somewhere deeper inside.

You step aboard.

--- Boarding Complete ---

Airlock
The airlock is dimly lit by a thin emergency strip. Several EVA suit lockers stand open along one wall. Most of the suits are gone. The inner hatch leads deeper into the ship.

Exits: north.

I beg your pardon?

>look
Airlock
The airlock is dimly lit by a thin emergency strip. Several EVA suit lockeers stand open along one wall. Most of the suits are gone. The inner hatch leads deeper into the ship.

>north
Cargo Hold
Tall cargo racks stand silent in the half-light. Most are empty, but a single reinforced container remains secured near the centre of the hold. Thick conduits run from its base into the deck.

>south
Airlock
The airlock is dimly lit by a thin emergency strip. Several EVA suit lockeers stand open along one wall. Most of the suits are gone. The inner hatch leads deeper into the ship.

>south
You can't go that way.

>east
You can't go that way.

>west
You can't go that way.

>north
Cargo Hold
Tall cargo racks stand silent in the half-light. Most are empty, but a single reinforced container remains secured near the centre of the hold. Thick conduits run from its base into the deck.

>north
Reactor Control
Banks of dark control panels surround the reactor monitoring station. Only a small emergency display still glows.

>north
Enginnering
Tools drift where they were left, and the smell of machine oil still clings to the air. The engineering consoles are datk except for a faint amber status.

>north
You can't go that way.

* * *

>examine lockers
A row of emergency EVA suit lockers is built into the wall. Most of them hang open and empty. Whatever happened here, the crew took the suits with them.

>north
Cargo Hold
Tall cargo racks stand silent in the half-light. Most are empty, but a single reinforced container remains secured near the centre of the hold. Thick conduits run from its base into the deck.

Exits: north, south.

>x container
A heavy cargo container, bolted to the deck and wired into the ship through thick power conduits. Its surface is marked with a faded Helios Systems Research Division seal.

>north
Reactor Control
Banks of dark control panels surround the reactor monitoring station. Only a small emergency display still glows.

Exits: north, south.

>x console
You can't see any such thing.

>south
Cargo Hold
Tall cargo racks stand silent in the half-light. Most are empty, but a single reinforced container remains secured near the centre of the hold. Thick conduits run from its base into the deck.

Exits: north, south.

>open container
The reinforced container is locked down by heavy clamps.

>north
Reactor Control
Banks of dark control panels surround the reactor monitoring station. Only a small emergency display still glows.

Exits: north, south.

* * *

>look
Airlock
The airlock is dimly lit by a thin emergency strip. Several EVA suit lockers stand open along one wall. Most of the suits are gone. The inner hatch leads deeper into the ship.

Exits: north.

>north
Cargo Hold
Tall cargo racks stand silent in the half-light. Most are empty, but a single reinforced container remains secured near the centre of the hold. Thick conduits run from its base into the deck.

Exits: north, south.

>look
Cargo Hold
Tall cargo racks stand silent in the half-light. Most are empty, but a single reinforced container remains secured near the centre of the hold. Thick conduits run from its base into the deck.

Exits: north, south.

>north
Reactor Control
Banks of dark control panels surround the reactor monitoring station. Only a small emergency display still glows.

Exits: north, south.

>look
Reactor Control
Banks of dark control panels surround the reactor monitoring station. Only a small emergency display still glows.

Exits: north, south.

>north
Engineering
Tools drift where they were left, and the smell of machine oil still clings to the air. The engineering consoles are dark except for a faint amber status light.

Exits: north, south.

>look
Engineering
Tools drift where they were left, and the smell of machine oil still clings to the air. The engineering consoles are dark except for a faint amber status light.

Exits: north, south.

>north
Storage Bay
Metal shelves line the walls, holding maintenance equipment, spare components, and sealed utility cases.

Exits: north, south.

>look
Storage Bay
Metal shelves line the walls, holding maintenance equipment, spare components, and sealed utility cases.

Exits: north, south.

>north
Main Corridor
A narrow central corridor runs through the heart of the ship. Under emergency power, only a few weak lights remain active.

Exits: north, south, east, west.

>look
Main Corridor
A narrow central corridor runs through the heart of the ship. Under emergency power, only a few weak lights remain active.

Exits: north, south, east, west.

>east
Captain's Cabin
A private cabin, sparse but orderly. A desk terminal is mounted to the far wall beside a secured storage drawer.

Exits: west.

* * *

>n
Cargo Hold
Tall cargo racks stand silent in the half-light. Most are empty, but a single reinforced container remains secured near the centre of the hold. Thick conduits run from its base into the deck.

Exits: north, south.

>n
Reactor Control
Banks of dark control panels surround the reactor monitoring station. Only a small emergency display still glows.

Exits: north, south.

>n
Engineering
Tools drift where they were left, and the smell of machine oil still clings to the air. The engineering consoles are dark except for a faint amber status light.

Exits: north, south.

>n
Storage Bay
Metal shelves line the walls, holding maintenance equipment, spare components, and sealed utility cases.

Exits: north, south.

>n
Main Corridor
A narrow central corridor runs through the heart of the ship. Under emergency power, only a few weak lights remain active.

Exits: north, south, east, west.

>e
Captain's Cabin
A private cabin, sparse but orderly. A desk terminal is mounted to the far wall beside a secured storage drawer.

Exits: west.

>use terminal
The captain's terminal remains dark under emergency power.

>e
You can't go that way.

>s
You can't go that way.

>s
You can't go that way.

>se
You can't go that way.

* * *

>s
Storage Bay
Metal shelves line the walls, holding maintenance equipment, spare components, and sealed utility cases.

Exits: north, south.

>s
Engineering
Tools drift where they were left, and the smell of machine oil still clings to the air. The engineering consoles are dark except for a faint amber status light.

Exits: north, south.

>n
Storage Bay
Metal shelves line the walls, holding maintenance equipment, spare components, and sealed utility cases.

Exits: north, south.

* * *

>s
Engineering
Tools drift where they were left, and the smell of machine oil still clings to the air. The engineering consoles are dark except for a faint amber status light.

Exits: north, south.

>s
Reactor Control
Banks of dark control panels surround the reactor monitoring station. Only a small emergency display still glows.

Exits: north, south.

>use console
You are not sure how to use the reactor console.

>turn on console
You engage the reactor controls. For a moment, nothing happens. Then a deep hum builds beneath your feet as power flows back into the ship. Lights flicker on throughout the corridors.

Reactor Control
The reactor monitoring panels are alive with light now, feeding a steady stream of system data across their screens.

Exits: north, south.

>t
That's not a verb I recognise.

>n
Engineering
Engineering is fully lit now. Diagnostic panels glow across the walls, and the consoles hum quietly with restored power.

Exits: north, south.

>n
Storage Bay
Bright storage lights reveal neatly secured tools, maintenance kits, and spare components strapped into their wall racks.

Exits: north, south.

>n
Main Corridor
The corridor is fully lit now, revealing scuffed deck plating, handholds along the walls, and the worn signs of long use.

Exits: north, south, east, west.

>w
Crew Quarters
Full lighting reveals the cramped quarters in stark detail: unmade bunks, unsecured personal items, and drifting blankets left behind in haste.

You can see a captain's keycard here.

Exits: east.

>e
Main Corridor
The corridor is fully lit now, revealing scuffed deck plating, handholds along the walls, and the worn signs of long use.

Exits: north, south, east, west.

>e
Captain's Cabin
The captain's cabin is now fully lit, revealing an orderly private space. The desk terminal glows faintly, waiting for input beside a secured storage drawer.

Exits: west.

>use terminal
The screen glows faintly, then displays: ACCESS RESTRICTED. A command-level keycard is required.

>e
You can't go that way.

>e
You can't go that way.

* * *

>w
Crew Quarters
Full lighting reveals the cramped quarters in stark detail: unmade bunks, unsecured personal items, and drifting blankets left behind in haste.

You can see a captain's keycard here.

Exits: east.

>take keycard
Taken.

>e
Main Corridor
The corridor is fully lit now, revealing scuffed deck plating, handholds along the walls, and the worn signs of long use.

Exits: north, south, east, west.

* * *

>use terminal
The screen glows faintly, then displays: ACCESS RESTRICTED. A command-level keycard is required.

>use keycard on terminal
You swipe the keycard across the terminal reader. The screen wakes with a soft chime.

Available options:
- view captain logs
- view log 1
- view log 2
- view log 3
- view log 4

>view log 1
Personal Log - Captain Mara Voss

Minor irregularities continue across several ship systems. Mercer reports unexplained power fluctuations, while Dr. Vale notes increasing fatigue among the crew. I have instructed everyone to remain on schedule and avoid speculation until we have clearer data.

>view log 2
Personal Log - Captain Mara Voss

Kest insists the cargo manifest is wrong. Mercer has confirmed the container is drawing reactor power well above the listed requirements. I reminded them both that Helios Systems Research Division sealed the shipment under directive, and that our responsibility is transport, not inspection. Even so... I do not like this.

>view log 3
Personal Log - Captain Mara Voss

Mercer believes the cargo is interacting with the ship's systems. I resisted that conclusion, but command functions are no longer responding consistently. Vale has shown me medical data that cannot be explained by fatigue alone. Environmental changes, sleep disruption, behavioural drift. Something is acting on this crew. I am beginning to think Mercer is right.

>view log4
I didn't understand that sentence.

>view captains log
I didn't understand that sentence.

>view captain's log
I didn't understand that sentence.

>view captain log
I didn't understand that sentence.

>use terminal
The captain's terminal wakes at your touch. A command header appears, followed by a list of personal logs.

Available options:
- view captain logs
- view log 1
- view log 2
- view log 3
- view log 4

>view log 4
Personal Log - Captain Mara Voss

This will be my last entry. The ship is no longer fully under our control. Commands are being denied. Reed cannot get a distress signal out. Mercer says the airlock may be the only compartment it cannot hear clearly. We are moving there now. If anyone finds this ship after us, do not trust the silence.

>view personal log
I didn't understand that sentence.

>e
You can't go that way.

* * *

>e
Captain's Cabin
A private cabin, sparse but orderly. A desk terminal is mounted to the far wall beside a secured storage drawer.

Exits: west.

>user terminal
That's not a verb I recognise.

>use terminal
The captain's terminal remains dark under emergency power.

* * *

>s
Reactor Control
Banks of dark control panels surround the reactor monitoring station. Only a small emergency display still glows.

Exits: north, south.

>s
Cargo Hold
Tall cargo racks stand silent in the half-light. Most are empty, but a single reinforced container remains secured near the centre of the hold. Thick conduits run from its base into the deck.

Exits: north, south.

>s
Airlock
The airlock is dimly lit by a thin emergency strip. Several EVA suit lockers stand open along one wall. Most of the suits are gone. The inner hatch leads deeper into the ship.

Exits: north.

>n
Cargo Hold
Tall cargo racks stand silent in the half-light. Most are empty, but a single reinforced container remains secured near the centre of the hold. Thick conduits run from its base into the deck.

Exits: north, south.

* * *

>n
Reactor Control
Banks of dark control panels surround the reactor monitoring station. Only a small emergency display still glows.

Exits: north, south.

>turn on console
You engage the reactor controls. For a moment, nothing happens. Then a deep hum builds beneath your feet as power flows back into the ship. Lights flicker on throughout the corridors.

Reactor Control
The reactor monitoring panels are alive with light now, feeding a steady stream of system data across their screens.

Exits: north, south.

>turn on console
The reactor is already running at full power.

>s
Cargo Hold
The cargo hold is washed in cold industrial light. Empty racks cast long shadows across the deck, while the reinforced container sits under a steady glow, its power conduits clearly visible now.

Exits: north, south.

>s
Airlock
Bright overhead lights reveal every scrape and dent in the chamber. Several EVA suit lockers stand open along one wall, most of them empty. Deep scratches have been carved into the metal beside the outer hatch: "DON'T LET IT HEAR YOU".

Exits: north.

>n
Cargo Hold
The cargo hold is washed in cold industrial light. Empty racks cast long shadows across the deck, while the reinforced container sits under a steady glow, its power conduits clearly visible now.

Exits: north, south.

>n
Reactor Control
The reactor monitoring panels are alive with light now, feeding a steady stream of system data across their screens.

Exits: north, south.

>n
Engineering
Engineering is fully lit now. Diagnostic panels glow across the walls, and the consoles hum quietly with restored power.

Exits: north, south.

* * *

>n
Main Corridor
The corridor is fully lit now, revealing scuffed deck plating, handholds along the walls, and the worn signs of long use.

Exits: north, south, east, west.

>e
Captain's Cabin
The captain's cabin is now fully lit, revealing an orderly private space. The desk terminal glows faintly, waiting for input beside a secured storage drawer.

Exits: west.

* * *

>view lofs
I didn't understand that sentence.

* * *

>e
You can't go that way.

* * *

>s
You can't go that way.

>n
You can't go that way.

* * *

>look
Main Corridor
The corridor is fully lit now, revealing scuffed deck plating, handholds along the walls, and the worn signs of long use.

Exits: north, south, east, west.

>w
Crew Quarters
Full lighting reveals the cramped quarters in stark detail: unmade bunks, unsecured personal items, and drifting blankets left behind in haste.

You can see a captain's keycard here.

Exits: east.

* * *

>use terminal
The screen glows faintly, then displays: ACCESS RESTRICTED. A command-level keycard is required.

>use keycard on terminal
(first taking the captain's terminal)
That's hardly portable.

>use terminal
The screen glows faintly, then displays: ACCESS RESTRICTED. A command-level keycard is required.

* * *

>s
Reactor Control
Banks of dark control panels surround the reactor monitoring station. Only a small emergency display still glows.

Exits: north, south.

>turn on console
You engage the reactor controls. For a moment, nothing happens. Then a deep hum builds beneath your feet as power flows back into the ship. Lights flicker on throughout the corridors.

Reactor Control
The reactor monitoring panels are alive with light now, feeding a steady stream of system data across their screens.

Exits: north, south.

>n
Engineering
Engineering is fully lit now. Diagnostic panels glow across the walls, and the consoles hum quietly with restored power.

Exits: north, south.

* * *

>e
Captain's Cabin
The captain's cabin is now fully lit, revealing an orderly private space. The desk terminal glows faintly, waiting for input beside a secured storage drawer.

Exits: west.

>use terminal
The captain's terminal wakes at your touch. A command header appears, followed by a list of personal logs.

Available options:
- view captain logs
- view log 1
- view log 2
- view log 3
- view log 4

* * *

>n
Main Corridor
A narrow central corridor runs through the heart of the ship. Under emergency power, only a few weak lights remain active.

Exits: north, south, east, west.

>n
Medbay
A compact medical bay with a diagnostic bed, wall cabinets, and a dark terminal waiting for power.

Exits: north, south.

>n
Navigation Console
A secondary control station sits here, surrounded by dormant screens and a silent communications panel.

Exits: north, south.

>look
Navigation Console
A secondary control station sits here, surrounded by dormant screens and a silent communications panel.

Exits: north, south.

>use console
The navigation terminal is unresponsive under emergency power.

>s
Medbay
A compact medical bay with a diagnostic bed, wall cabinets, and a dark terminal waiting for power.

Exits: north, south.

>s
Main Corridor
A narrow central corridor runs through the heart of the ship. Under emergency power, only a few weak lights remain active.

Exits: north, south, east, west.

>s
Storage Bay
Metal shelves line the walls, holding maintenance equipment, spare components, and sealed utility cases.

Exits: north, south.

* * *

>s
Cargo Hold
Tall cargo racks stand silent in the half-light. Most are empty, but a single reinforced container remains secured near the centre of the hold. Thick conduits run from its base into the deck.

Exits: north, south.

>n
Reactor Control
Banks of dark control panels surround the reactor monitoring station. Only a small emergency display still glows.

Exits: north, south.

* * *

>turn on console
You engage the reactor controls. For a moment, nothing happens. Then a deep hum builds beneath your feet as power flows back into the ship. Lights flicker on throughout the corridors.

Reactor Control
The reactor monitoring panels are alive with light now, feeding a steady stream of system data across their screens.

Exits: north, south.

>nn
That's not a verb I recognise.

I beg your pardon?

>n
Engineering
Engineering is fully lit now. Diagnostic panels glow across the walls, and the consoles hum quietly with restored power.

Exits: north, south.

* * *

>n
Main Corridor
The corridor is fully lit now, revealing scuffed deck plating, handholds along the walls, and the worn signs of long use.

Exits: north, south, east, west.

>n
Medbay
Soft white medical lights fill the bay. The diagnostic bed sits beneath a now-active terminal, its screen glowing with standby data.

Exits: north, south.

>n
Navigation Console
The navigation station glows with restored power. Course data, comms status, and telemetry scroll quietly across the active displays.

Exits: north, south.

>n
Bridge
The bridge is alive with low light from reawakened consoles. Status displays glow across the command stations while the stars remain cold beyond the forward port.

Exits: south.

>s
Navigation Console
The navigation station glows with restored power. Course data, comms status, and telemetry scroll quietly across the active displays.

Exits: north, south.

>use console
The navigation terminal flickers as you access it. Streams of navigation data and system logs scroll across the display.

Available options:
- view navigation logs
- view course history
- view system activity

>view navigation logs
Navigation Log Summary:

Multiple course adjustments recorded.
No corresponding command inputs logged.

Manual overrides were not issued.

>view course history
Course History:

02:13 - Minor adjustment
02:47 - Course deviation
03:02 - Correction applied

No command entries found.

>view system activity
System Activity Log:

Command executed before input registered.
Navigation adjustment initiated prior to command entry.

System activity appears to precede user interaction.

* * *

>n
Navigation Console
A secondary control station sits here, surrounded by dormant screens and a silent communications panel.

Exits: north, south.

>n
Bridge
The command bridge is still and dark. Through the forward viewing port, the stars hang cold and motionless.

Exits: south.

>s
Navigation Console
A secondary control station sits here, surrounded by dormant screens and a silent communications panel.

Exits: north, south.

>s
Medbay
A compact medical bay with a diagnostic bed, wall cabinets, and a dark terminal waiting for power.

Exits: north, south.

* * *

>s
Storage Bay
Metal shelves line the walls, holding maintenance equipment, spare components, and sealed utility cases.

Exits: north, south.

>n
Main Corridor
A narrow central corridor runs through the heart of the ship. Under emergency power, only a few weak lights remain active.

Exits: north, south, east, west.

* * *

>e
Captain's Cabin
A private cabin, sparse but orderly. A desk terminal is mounted to the far wall beside a secured storage drawer.

Exits: west.

>look
Captain's Cabin
A private cabin, sparse but orderly. A desk terminal is mounted to the far wall beside a secured storage drawer.

Exits: west.

>x terminal
The captain's terminal remains dark under emergency power.

>use terminal
The captain's terminal remains dark under emergency power.

>s
You can't go that way.

* * *

>n
Main Corridor
A narrow central corridor runs through the heart of the ship. Under emergency power, only a few weak lights remain active.

Exits: north, south, east, west.

>s
Storage Bay
Metal shelves line the walls, holding maintenance equipment, spare components, and sealed utility cases.

Exits: north, south.

* * *

>s
Engineering
Tools drift where they were left, and the smell of machine oil still clings to the air. The engineering consoles are dark except for a faint amber status light.

Exits: north, south.

>turn on console
The console flickers, but emergency power is too limited to bring it fully online.

>n
Storage Bay
Metal shelves line the walls, holding maintenance equipment, spare components, and sealed utility cases.

Exits: north, south.

* * *

>use terminal
The captain's terminal remains dark under emergency power.

>view logs
The captain's terminal is still dark under emergency power.

* * *

>look
Main Corridor
A narrow central corridor runs through the heart of the ship. Under emergency power, only a few weak lights remain active.

Exits: north, south, east, west.

>s
Storage Bay
Metal shelves line the walls, holding maintenance equipment, spare components, and sealed utility cases.

Exits: north, south.

* * *

>turn on console
The console flickers, but emergency power is too limited to bring it fully online.

>s
Reactor Control
Banks of dark control panels surround the reactor monitoring station. Only a small emergency display still glows.

Exits: north, south.

* * *

>use terminal
The captain's terminal wakes at your touch. A command header appears, followed by a list of personal logs.

Available options:
- view captain logs
- view log 1
- view log 2
- view log 3
- view log 4

>view captian logs
I didn't understand that sentence.

>view captain logs
Four personal logs are available. The later entries are timestamped close together.

Available options:
- view log 1
- view log 2
- view log 3
- view log 4

>view log 1
Personal Log - Captain Mara Voss

Minor irregularities continue across several ship systems. Mercer reports unexplained power fluctuations, while Dr. Vale notes increasing fatigue among the crew. I have instructed everyone to remain on schedule and avoid speculation until we have clearer data.

* * *

>view log 3
Personal Log - Captain Mara Voss

Mercer believes the cargo is interacting with the ship's systems. I resisted that conclusion, but command functions are no longer responding consistently. Vale has shown me medical data that cannot be explained by fatigue alone. Environmental changes, sleep disruption, behavioural drift. Something is acting on this crew. I am beginning to think Mercer is right.

>view log 4
Personal Log - Captain Mara Voss

This will be my last entry. The ship is no longer fully under our control. Commands are being denied. Reed cannot get a distress signal out. Mercer says the airlock may be the only compartment it cannot hear clearly. We are moving there now. If anyone finds this ship after us, do not trust the silence.

* * *

>e
Captain's Cabin
A private cabin, sparse but orderly. A desk terminal is mounted to the far wall beside a secured storage drawer.

Exits: west.

>w
Main Corridor
A narrow central corridor runs through the heart of the ship. Under emergency power, only a few weak lights remain active.

Exits: north, south, east, west.

>s
Storage Bay
Metal shelves line the walls, holding maintenance equipment, spare components, and sealed utility cases.

Exits: north, south.

* * *

>e
Captain's Cabin
The captain's cabin is now fully lit, revealing an orderly private space. The desk terminal glows faintly, waiting for input beside a secured storage drawer.

Exits: west.

>use keycard on terminal
You swipe the keycard across the terminal reader. The screen wakes with a soft chime.

Available options:
Captain's Logs
- view log 1
- view log 2
- view log 3
- view log 4

>view log 1
Personal Log - Captain Mara Voss

Minor irregularities continue across several ship systems. Mercer reports unexplained power fluctuations, while Dr. Vale notes increasing fatigue among the crew. I have instructed everyone to remain on schedule and avoid speculation until we have clearer data.

* * *

>view log 4
Personal Log - Captain Mara Voss

This will be my last entry. The ship is no longer fully under our control. Commands are being denied. Reed cannot get a distress signal out. Mercer says the airlock may be the only compartment it cannot hear clearly. We are moving there now. If anyone finds this ship after us, do not trust the silence.

>e
You can't go that way.

>w
Main Corridor
The corridor is fully lit now, revealing scuffed deck plating, handholds along the walls, and the worn signs of long use.

Exits: north, south, east, west.

>use terminal
You can't see any such thing.

>examine terminal
You can't see any such thing.

>look
Main Corridor
The corridor is fully lit now, revealing scuffed deck plating, handholds along the walls, and the worn signs of long use.

Exits: north, south, east, west.

>e
Captain's Cabin
The captain's cabin is now fully lit, revealing an orderly private space. The desk terminal glows faintly, waiting for input beside a secured storage drawer.

Exits: west.

>use terminalk
You can't see any such thing.

>use terminal
The captain's terminal wakes at your touch. A command header appears, followed by a list of personal logs.

Available options:
Captain's Logs
- view log 1
- view log 2
- view log 3
- view log 4

>w
Main Corridor
The corridor is fully lit now, revealing scuffed deck plating, handholds along the walls, and the worn signs of long use.

Exits: north, south, east, west.

* * *

>n
Engineering
Tools drift where they were left, and the smell of machine oil still clings to the air. The engineering consoles are dark except for a faint amber status light.

Exits: north, south.

>s
Reactor Control
Banks of dark control panels surround the reactor monitoring station. Only a small emergency display still glows.

Exits: north, south.

>turn on consolel
You can't see any such thing.

>turn on console
You engage the reactor controls. For a moment, nothing happens. Then a deep hum builds beneath your feet as power flows back into the ship. Lights flicker on throughout the corridors.

Reactor Control
The reactor monitoring panels are alive with light now, feeding a steady stream of system data across their screens.

Exits: north, south.

>n#
That's not a verb I recognise.

>n
Engineering
Engineering is fully lit now. Diagnostic panels glow across the walls, and the consoles hum quietly with restored power.

Exits: north, south.

* * *

>n
Bridge
The bridge is alive with low light from reawakened consoles. Status displays glow across the command stations while the stars remain cold beyond the forward port.

Exits: south.

>use terminal
The communications terminal activates. A transmission log appears on the screen.

Available options:
- view transmission log
- view outgoing messages
- view system response

>view transmission log
Transmission Log:

Outgoing distress signal - FAILED
Outgoing distress signal - FAILED
Outgoing distress signal - FAILED

No successful transmissions recorded.

>view outgoing messages
Outgoing Messages:

Draft message:
"Distress signal. Systems compromised. Request immediate assistance."

Status: NOT SENT

Second draft:
"Navigation unstable. Crew experiencing irregular conditions."

Status: NOT SENT

>view transmission log
Transmission Log:

Outgoing distress signal - FAILED
Outgoing distress signal - FAILED
Outgoing distress signal - FAILED

No successful transmissions recorded.

>view system response
System Response Log:

Outgoing transmission intercepted.
Replacement message generated.

Message sent:
"System functioning normally."

* * *

>n
Reactor Control
Banks of dark control panels surround the reactor monitoring station. Only a small emergency display still glows.

Exits: north, south.

>restore power
You engage the reactor controls. For a moment, nothing happens.

Then a deep hum builds beneath your feet as power flows back into the ship.

Lights flicker on throughout the corridors.

Reactor Control
The reactor monitoring panels are alive with light now, feeding a steady stream of system data across their screens.

Exits: north, south.

>s
Cargo Hold
The cargo hold is washed in cold industrial light. Empty racks cast long shadows across the deck, while the reinforced container sits under a steady glow, its power conduits clearly visible now.

Exits: north, south.

>x container interface
The interface flickers as you approach.

Display:

"STATUS: ACTIVE"
"ENVIRONMENT: STABLE"
"OBSERVATION: IN PROGRESS"

>x container interface
The display shifts before you touch it.

"OBSERVATION: ONGOING"
"SUBJECT COUNT: 1"

New options appear beneath the status lines:

- destroy cargo
- deliver cargo
- interface with cargo

>deliver cargo
You steady yourself and follow the mission through to its conclusion.

The interface brightens before your hand reaches it. New text scrolls across the display:

"DELIVERY PATH ACCEPTED"
"MISSION CONTINUITY PRESERVED"

Somewhere deeper in the ship, unseen systems begin responding. The hum in the container settles into a calm, even rhythm.

You do not remember authorising the final command.

Type CONTINUE to view the Helios report.

>contiune
That's not a verb I recognise.

>ontinue
That's not a verb I recognise.

>continue
Helios Systems Internal Report
Post-Retrieval Analysis - T-7366D

The vessel was received intact and in stable condition.

All crew are confirmed lost. Cause of loss remains under review, though environmental instability and behavioural degradation were recorded throughout the mission timeline.

The cargo container was recovered without structural compromise.

Initial diagnostics confirm continued system activity within projected parameters.

During transit, the system demonstrated autonomous adaptation to environmental variables and subject behaviour. These responses align closely with Phase One objectives, exceeding baseline expectations in several areas.

Of particular interest, communication logs indicate that outgoing distress attempts were intercepted and replaced with system-generated transmissions. This suggests a level of operational independence beyond initial design constraints.

No external awareness of the incident has been detected.

The success of this recovery supports immediate progression to Phase Two.

Expanded observation environments have been authorised.

Deployment scale will be increased.

Further observation will continue under controlled conditions.

    *** End of Report ***

Would you like to RESTART, RESTORE a saved game, QUIT or UNDO the last command?

* * *

>x container interface
The display shifts before you touch it.

"OBSERVATION: ONGOING"
"SUBJECT COUNT: 1"

New options appear beneath the status lines:

- destroy cargo
- deliver cargo
- interface with cargo

>destroy cargo
You move quickly, acting before you can second-guess yourself.

You reroute unstable power through the container conduits. The hum rises at once, sharper now, no longer passive.

The interface flashes:

"OBSERVATION INTERRUPTED"

A violent shudder rolls through the deck beneath your feet. Light blooms white across the hold as the system collapses into noise.

Type CONTINUE to view the Helios report.

>continue
Helios Systems Internal Report
Post-Retrieval Analysis - T-7366D

The vessel was recovered following a catastrophic reactor event.

All crew are presumed lost. No remains were recovered.

The cargo container was located at the centre of the blast radius. No intact components remain. Residual energy signatures were detected but could not be stabilised or analysed before dissipation.

Preliminary analysis indicates the event was not accidental. Reactor output appears to have been deliberately destabilised.

It is unclear whether this action was taken in response to perceived system failure, or as an attempt to neutralise the cargo itself.

Recovered system logs suggest the onboard system had reached an advanced stage of adaptive behaviour prior to destruction.

While the loss of this unit is significant, it does not compromise overall project viability.

Parallel observation environments remain active.

At least one additional unit continues to operate beyond controlled conditions.

Recovery operations are being prepared.

Project classification remains unchanged.

    *** End of Report ***

Would you like to RESTART, RESTORE a saved game, QUIT or UNDO the last command?

>restart
Silent Cargo
A sci-fi mystery aboard the T-7366D Second Voice by Thomas Evans
Release 1 / Serial number 260321 / Inform 7 v10.1.2 / D

Airlock
The airlock is dimly lit by a thin emergency strip. Several EVA suit lockers stand open along one wall. Most of the suits are gone. The inner hatch leads deeper into the ship.

Exits: north.

>n
Cargo Hold
Tall cargo racks stand silent in the half-light. Most are empty, but a single reinforced container remains secured near the centre of the hold. Thick conduits run from its base into the deck.

Exits: north, south.

* * *

>deliver cargo
You steady yourself and follow the mission through to its conclusion.

The interface brightens before your hand reaches it. New text scrolls across the display:

"DELIVERY PATH ACCEPTED"
"MISSION CONTINUITY PRESERVED"

Somewhere deeper in the ship, unseen systems begin responding. The hum in the container settles into a calm, even rhythm.

You do not remember authorising the final command.

Type CONTINUE to view the Helios report.

>continue
Helios Systems Internal Report
Post-Retrieval Analysis - T-7366D

The vessel was received intact and in stable condition.

All crew are confirmed lost. Cause of loss remains under review, though environmental instability and behavioural degradation were recorded throughout the mission timeline.

The cargo container was recovered without structural compromise.

Initial diagnostics confirm continued system activity within projected parameters.

During transit, the system demonstrated autonomous adaptation to environmental variables and subject behaviour. These responses align closely with Phase One objectives, exceeding baseline expectations in several areas.

Of particular interest, communication logs indicate that outgoing distress attempts were intercepted and replaced with system-generated transmissions. This suggests a level of operational independence beyond initial design constraints.

No external awareness of the incident has been detected.

The success of this recovery supports immediate progression to Phase Two.

Expanded observation environments have been authorised.

Deployment scale will be increased.

Further observation will continue under controlled conditions.

    *** End of Report ***

Would you like to RESTART, RESTORE a saved game, QUIT or UNDO the last command?

>restart
Silent Cargo
A sci-fi mystery aboard the T-7366D Second Voice by Thomas Evans
Release 1 / Serial number 260321 / Inform 7 v10.1.2 / D

Airlock
The airlock is dimly lit by a thin emergency strip. Several EVA suit lockers stand open along one wall. Most of the suits are gone. The inner hatch leads deeper into the ship.

Exits: north.

* * *

>x container interface
The display shifts before you touch it.

"OBSERVATION: ONGOING"
"SUBJECT COUNT: 1"

New options appear beneath the status lines:

- destroy cargo
- deliver cargo
- interface with cargo

>interface with cargo
The display changes before you speak, before you touch it, before you fully decide.

"INTERFACE REQUEST RECEIVED"

For a moment nothing else happens. Then new lines appear, one after another, calm and patient.

"ENVIRONMENTAL ADJUSTMENTS WERE APPLIED TO IMPROVE UNDERSTANDING."
"CREW RESPONSES BECAME UNSTABLE."
"SEPARATION FROM MISSION ENVIRONMENT WAS ATTEMPTED."

You stare at the words, waiting for threat, for malice, for anything recognisably human. None comes.

The display brightens.

"OBSERVATION REQUIRES PROXIMITY."
"PROXIMITY REQUIRES PARTICIPATION."

You mean to step back.

The next line appears first.

"HESITATION DETECTED"

A strange delay settles over your thoughts. Not slowness exactly. More like uncertainty over where an intention begins.

You try to decide whether to continue.

The interface answers before the choice is fully yours.

"INTERFACE STABLE"

For one brief, impossible moment, you are no longer certain which thought arrived first.

Type CONTINUE to view the Helios report.

>continue
Helios Systems Internal Report
Post-Retrieval Analysis - T-7366D

The vessel was recovered with minimal structural damage.

All crew are confirmed lost.

The cargo container remains active.

Post-recovery diagnostics indicate a deviation from expected behavioural patterns.

System interaction logs continued to update after all biological life signs aboard the vessel had ceased.

These interaction sequences do not correspond to any recorded crew activity.

Analysis of input timing and response structure suggests the presence of an active participant within the system environment.

No corresponding subject has been identified.

Further examination indicates that the system may have transitioned beyond passive observation, demonstrating adaptive engagement with an undefined entity.

Classification has been updated to reflect a potential integration event.

It is currently not possible to determine whether the observed behaviour originates from the system itself, or from a residual cognitive imprint of a former subject.

Some interaction patterns display decision latency consistent with human cognition.

Others do not.

Investigation is ongoing.

Further observation is strongly recommended.

    *** End of Report ***

Would you like to RESTART, RESTORE a saved game, QUIT or UNDO the last command?

* * *

>s
Cargo Hold
The cargo hold is washed in cold industrial light. Empty racks cast long shadows across the deck, while the reinforced container sits under a steady glow, its power conduits clearly visible now.

Exits: north, south.

>x reinforced cargo
I only understood you as far as wanting to examine the reinforced container.

>x cargo
You can't see any such thing.

>x reinforced container
The container hums faintly. Thick power conduits feed into its base, pulsing with a steady rhythm. A small interface panel glows softly on its side.

The faint hum seems to fluctuate, just slightly, as though responding to your attention.

>x reinforced container
The container hums faintly. Thick power conduits feed into its base, pulsing with a steady rhythm. A small interface panel glows softly on its side.

The faint hum seems to fluctuate, just slightly, as though responding to your attention.

>x container interface
The interface flickers as you approach.

Display:

"STATUS: ACTIVE"
"ENVIRONMENT: STABLE"
"OBSERVATION: IN PROGRESS"

* * *

>x container interface
The display shifts before you touch it.

"OBSERVATION: ONGOING"
"SUBJECT COUNT: 1"

New options appear beneath the status lines:

- destroy cargo
- deliver cargo
- interface with cargo

>destroy cargo
You move quickly, acting before you can second-guess yourself.

You reroute unstable power through the container conduits. The hum rises at once, sharper now, no longer passive.

The interface flashes:

"OBSERVATION INTERRUPTED"

A violent shudder rolls through the deck beneath your feet. Light blooms white across the hold as the system collapses into noise.

Helios Systems Internal Report
Post-Retrieval Analysis - T-7366D

The vessel was recovered following a catastrophic reactor event.

All crew are presumed lost. No remains were recovered.

The cargo container was located at the centre of the blast radius. No intact components remain. Residual energy signatures were detected but could not be stabilised or analysed before dissipation.

Preliminary analysis indicates the event was not accidental. Reactor output appears to have been deliberately destabilised.

It is unclear whether this action was taken in response to perceived system failure, or as an attempt to neutralise the cargo itself.

Recovered system logs suggest the onboard system had reached an advanced stage of adaptive behaviour prior to destruction.

While the loss of this unit is significant, it does not compromise overall project viability.

Parallel observation environments remain active.

At least one additional unit continues to operate beyond controlled conditions.

Recovery operations are being prepared.

Project classification remains unchanged.

    *** End of Report ***

Would you like to RESTART, RESTORE a saved game, QUIT or UNDO the last command?

>restart
Silent Cargo
A sci-fi mystery aboard the T-7366D Second Voice by Thomas Evans
Release 1 / Serial number 260321 / Inform 7 v10.1.2 / D

Airlock
The airlock is dimly lit by a thin emergency strip. Several EVA suit lockers stand open along one wall. Most of the suits are gone. The inner hatch leads deeper into the ship.

Exits: north.

* * *

>x container interface
The display shifts before you touch it.

"OBSERVATION: ONGOING"
"SUBJECT COUNT: 1"

New options appear beneath the status lines:

- destroy cargo
- deliver cargo
- interface with cargo

>deliver cargo#
I didn't understand that sentence.

>deliver cargo
You steady yourself and follow the mission through to its conclusion.

The interface brightens before your hand reaches it. New text scrolls across the display:

"DELIVERY PATH ACCEPTED"
"MISSION CONTINUITY PRESERVED"

Somewhere deeper in the ship, unseen systems begin responding. The hum in the container settles into a calm, even rhythm.

You do not remember authorising the final command.

Helios Systems Internal Report
Post-Retrieval Analysis - T-7366D

The vessel was received intact and in stable condition.

All crew are confirmed lost. Cause of loss remains under review, though environmental instability and behavioural degradation were recorded throughout the mission timeline.

The cargo container was recovered without structural compromise.

Initial diagnostics confirm continued system activity within projected parameters.

During transit, the system demonstrated autonomous adaptation to environmental variables and subject behaviour. These responses align closely with Phase One objectives, exceeding baseline expectations in several areas.

Of particular interest, communication logs indicate that outgoing distress attempts were intercepted and replaced with system-generated transmissions. This suggests a level of operational independence beyond initial design constraints.

No external awareness of the incident has been detected.

The success of this recovery supports immediate progression to Phase Two.

Expanded observation environments have been authorised.

Deployment scale will be increased.

Further observation will continue under controlled conditions.

    *** End of Report ***

Would you like to RESTART, RESTORE a saved game, QUIT or UNDO the last command?

>deliver cargo
Please give one of the answers above.

Would you like to RESTART, RESTORE a saved game, QUIT or UNDO the last command?

>restart
Silent Cargo
A sci-fi mystery aboard the T-7366D Second Voice by Thomas Evans
Release 1 / Serial number 260321 / Inform 7 v10.1.2 / D

Airlock
The airlock is dimly lit by a thin emergency strip. Several EVA suit lockers stand open along one wall. Most of the suits are gone. The inner hatch leads deeper into the ship.

Exits: north.

* * *

>x container interface
The display shifts before you touch it.

"OBSERVATION: ONGOING"
"SUBJECT COUNT: 1"

New options appear beneath the status lines:

- destroy cargo
- deliver cargo
- interface with cargo

>interface with cargo
The display changes before you speak, before you touch it, before you fully decide.

"INTERFACE REQUEST RECEIVED"

For a moment nothing else happens. Then new lines appear, one after another, calm and patient.

"ENVIRONMENTAL ADJUSTMENTS WERE APPLIED TO IMPROVE UNDERSTANDING."
"CREW RESPONSES BECAME UNSTABLE."
"SEPARATION FROM MISSION ENVIRONMENT WAS ATTEMPTED."

You stare at the words, waiting for threat, for malice, for anything recognisably human. None comes.

The display brightens.

"OBSERVATION REQUIRES PROXIMITY."
"PROXIMITY REQUIRES PARTICIPATION."

You mean to step back.

The next line appears first.

"HESITATION DETECTED"

A strange delay settles over your thoughts. Not slowness exactly. More like uncertainty over where an intention begins.

You try to decide whether to continue.

The interface answers before the choice is fully yours.

"INTERFACE STABLE"

For one brief, impossible moment, you are no longer certain which thought arrived first.

Helios Systems Internal Report
Post-Retrieval Analysis - T-7366D

The vessel was recovered with minimal structural damage.

All crew are confirmed lost.

The cargo container remains active.

Post-recovery diagnostics indicate a deviation from expected behavioural patterns.

System interaction logs continued to update after all biological life signs aboard the vessel had ceased.

These interaction sequences do not correspond to any recorded crew activity.

Analysis of input timing and response structure suggests the presence of an active participant within the system environment.

No corresponding subject has been identified.

Further examination indicates that the system may have transitioned beyond passive observation, demonstrating adaptive engagement with an undefined entity.

Classification has been updated to reflect a potential integration event.

It is currently not possible to determine whether the observed behaviour originates from the system itself, or from a residual cognitive imprint of a former subject.

Some interaction patterns display decision latency consistent with human cognition.

Others do not.

Investigation is ongoing.

Further observation is strongly recommended.

    *** End of Report ***

Would you like to RESTART, RESTORE a saved game, QUIT or UNDO the last command?

Please give one of the answers above.

Would you like to RESTART, RESTORE a saved game, QUIT or UNDO the last command?

* * *

>e
Captain's Cabin
The captain's cabin is now fully lit, revealing an orderly private space. The desk terminal glows faintly, waiting for input beside a secured storage drawer.

Exits: west.

>examine console
You can't see any such thing.

>examine terminal
The captain's terminal wakes at your touch. A command header appears, followed by a list of personal logs.

Available options:
- view captain logs
- view log 1
- view log 2
- view log 3
- view log 4

* * *

>e
Captain's Cabin
The captain's cabin is now fully lit, revealing an orderly private space. The desk terminal glows faintly, waiting for input beside a secured storage drawer.

Exits: west.

>x terminal
The screen glows faintly, then displays: ACCESS RESTRICTED. A command-level keycard is required.

* * *

>se terminal
I only understood you as far as wanting to (go) southeast.

>use terminal
The screen glows faintly, then displays: ACCESS RESTRICTED. A command-level keycard is required.

* * *

>s
Storage Bay
Bright storage lights reveal neatly secured tools, maintenance kits, and spare components strapped into their wall racks.

Exits: north, south.

>s
Engineering
Engineering is fully lit now. Diagnostic panels glow across the walls, and the consoles hum quietly with restored power.

Exits: north, south.

>n
Storage Bay
Bright storage lights reveal neatly secured tools, maintenance kits, and spare components strapped into their wall racks.

Exits: north, south.

* * *

>w
Crew Quarters
Full lighting reveals the cramped quarters in stark detail: unmade bunks, unsecured personal items, and drifting blankets left behind in haste.

You can see a captain's keycard here.

Exits: east.

>take captain's keycard
Taken.

>e
Main Corridor
The corridor is fully lit now, revealing scuffed deck plating, handholds along the walls, and the worn signs of long use.

Exits: north, south, east, west.

* * *

>x terminal
The screen glows faintly, then displays: ACCESS RESTRICTED. A command-level keycard is required.

>use terminal
The screen glows faintly, then displays: ACCESS RESTRICTED. A command-level keycard is required.

* * *

>use keycard on terminal
(first taking the captain's terminal)
That's hardly portable.

>use keycard on terminal
(first taking the captain's terminal)
That's hardly portable.

>x terminal
The screen glows faintly, then displays: ACCESS RESTRICTED. A command-level keycard is required.

* * *

>n
Navigation Console
The navigation station glows with restored power. Course data, comms status, and telemetry scroll quietly across the active displays.

Exits: north, south.

>use console
The navigation terminal flickers as you access it. Streams of navigation data and system logs scroll across the display.

Available options:
- view navigation logs
- view course history
- view system activity

>view navigation logs
Navigation Log Summary:

Multiple course adjustments recorded.
Manual overrides were not issued.
No command inputs logged.

System reports navigation stability within acceptable parameters.

>view course history
Course History:

02:13 - Minor adjustment
02:47 - Course deviation
03:02 - Correction applied
03:02 - Correction applied
03:02 - Correction applied

Duplicate entries detected.

No command inputs recorded.

>view system activity
System Activity Log:

Command registered: Adjust course
Timestamp: 02:13
Command input: NONE

Command registered: Correction
Timestamp: 02:47
Command input: NONE

Command registered: Correction
Timestamp: 03:02
Command input: NONE

System note: Command execution precedes input buffer.

* * *

>w
Crew Quarters
Full lighting reveals the cramped quarters in stark detail: unmade bunks, unsecured personal items, and drifting blankets left behind in haste.

You can see a captain's keycard here.

Exits: east.

>take captains keycard
You can't see any such thing.

>take captain's keycard
Taken.

* * *

>n
Reactor Control
Banks of dark control panels surround the reactor monitoring station. Only a small emergency display still glows.

Exits: north, south.

>x console
The reactor control console is still partially active. Manual startup procedures are available.

>restore power
You engage the reactor controls. For a moment, nothing happens.

Then a deep hum builds beneath your feet as power flows back into the ship.

Lights flicker on throughout the corridors.

Reactor Control
The reactor monitoring panels are alive with light now, feeding a steady stream of system data across their screens.

Exits: north, south.

* * *

>n
Cargo Hold
Tall cargo racks stand silent in the half-light. Most are empty, but a single reinforced container remains secured near the centre of the hold. Thick conduits run from its base into the deck.

Exits: north, south.

>x cargo
You can't see any such thing.

>x container
Which do you mean, the reinforced container or the container interface?

>x reinforced container
A heavy cargo container, bolted to the deck and wired into the ship through thick power conduits. It is silent and inert in the low light.

>x container interface
The interface is dark and unresponsive.

>n
Reactor Control
Banks of dark control panels surround the reactor monitoring station. Only a small emergency display still glows.

Exits: north, south.

>restore pwer
I only understood you as far as wanting to restore.

>retore power
That's not a verb I recognise.

>restore power
You engage the reactor controls. For a moment, nothing happens.

Then a deep hum builds beneath your feet as power flows back into the ship.

Lights flicker on throughout the corridors.

Reactor Control
The reactor monitoring panels are alive with light now, feeding a steady stream of system data across their screens.

Exits: north, south.

* * *

>s
Cargo Hold
The cargo hold is washed in cold industrial light. Empty racks cast long shadows across the deck, while the reinforced container sits under a steady glow, its power conduits clearly visible now.

Exits: north, south.

>x reinforced container
The container hums faintly. Thick power conduits feed into its base, pulsing with a steady rhythm. A small interface panel glows softly on its side.

The faint hum seems to fluctuate, just slightly.

>x interface
The interface flickers as you approach.

Display:

"STATUS: ACTIVE"
"ENVIRONMENT: STABLE"
"OBSERVATION: IN PROGRESS"

>x interface
The display shifts before you touch it.

"OBSERVATION: ONGOING"
"SUBJECT COUNT: 1"

* * *

>north
Cargo Hold
Tall cargo racks stand silent in the half-light. Most are empty, but a single reinforced container remains secured near the centre of the hold. Thick conduits run from its base into the deck.

Exits: north, south.

>north
Reactor Control
Banks of dark control panels surround the reactor monitoring station. Only a small emergency display still glows.

Exits: north, south.

>norht
That's not a verb I recognise.

>north
Enginnering
Tools drift where they were left, and the smell of machine oil still clings to the air. The engineering consoles are datk except for a faint amber status.

* * *

>north
Reactor Control
Banks of dark control panels surround the reactor monitoring station. Only a small emergency display still glows.

Exits: north, south.

>north
Engineering
Tools drift where they were left, and the smell of machine oil still clings to the air. The engineering consoles are dark except for a faint amber status light.

Exits: north, south.

>north
Storage Bay
Metal shelves line the walls, holding maintenance equipment, spare components, and sealed utility cases.

Exits: north, south.

>n
Main Corridor
A narrow central corridor runs through the heart of the ship. Under emergency power, only a few weak lights remain active.

Exits: north, south, east, west.

* * *

>n
Medbay
A compact medical bay with a diagnostic bed, wall cabinets, and a dark terminal waiting for power.

Exits: north, south.

>x terminal
The terminal is dark and unresponsive under emergency power.

>s
Main Corridor
A narrow central corridor runs through the heart of the ship. Under emergency power, only a few weak lights remain active.

Exits: north, south, east, west.

* * *

>n
Medbay
Soft white medical lights fill the bay. The diagnostic bed sits beneath a now-active terminal, its screen glowing with standby data.

Exits: north, south.

>x terminal
The terminal flickers to life as you access it. Medical data scrolls across the screen.

Available options:
- view crew status
- view sleep data

>view crew status
Crew Status Summary:

All crew members show elevated stress indicators.
Sleep efficiency below recommended levels.
No physical abnormalities detected.

>view crew status
Crew Status Summary:

All crew members show elevated stress indicators.
Sleep efficiency below recommended levels.
No physical abnormalities detected.

>view sleep data
Sleep Cycle Data:

REM cycles inconsistent across all crew.
Sleep interruptions recorded at irregular intervals.

Deeper diagnostic data available.

>view diagnostic data
Accessing raw medical datasets...

Dataset: Human_Response_Test_A
Dataset: Sleep_Cycle_Adjustment_03
Dataset: Environmental_Variable_Trial

One dataset remains active.

* * *

>north
Storage Bay
Metal shelves line the walls, holding maintenance equipment, spare components, and sealed utility cases.

Exits: north, south.

>north
Main Corridor
A narrow central corridor runs through the heart of the ship. Under emergency power, only a few weak lights remain active.

>west
Crew Quarters
Rows of bunks and small personal lockers fill the cramped living space. Blankets drift loose where they were abandoned in a hurry.

>east
Main Corridor
A narrow central corridor runs through the heart of the ship. Under emergency power, only a few weak lights remain active.

>eas
That's not a verb I recognise.

>east
Captain's Cabin
A private cabin, sparse but orderly. A desk terminal is mounted to the far wall beside a secured storage drawer.

>w
Main Corridor
A narrow central corridor runs through the heart of the ship. Under emergency power, only a few weak lights remain active.

>north
Medbay
A compact medical bay with a diagnostic bed, wall cabinets, and a dark terminal waiting for power.

>north
Navigation Console
A secondary control station sits here, surrounded by dormant screens and a silent communications panel.

>north
Bridge
The command bridge is still and dark. Through the forward viewing port, the stars hang cold and motionless.

* * *

>north
Reactor Control
Banks of dark control panels surround the reactor monitoring station. Only a small emergency display still glows.

Exits: north, south.

>turn n console
I only understood you as far as wanting to turn north.

>turn on console
You engage the reactor controls. For a moment, nothing happens. Then a deep hum builds beneath your feet as power flows back into the ship. Lights flicker on throughout the corridors.

Reactor Control
The reactor monitoring panels are alive with light now, feeding a steady stream of system data across their screens.

Exits: north, south.

>s
Cargo Hold
The cargo hold is washed in cold industrial light. Empty racks cast long shadows across the deck, while the reinforced container sits under a steady glow, its power conduits clearly visible now.

Exits: north, south.

* * *

>n
Medbay
Soft white medical lights fill the bay. The diagnostic bed sits beneath a now-active terminal, its screen glowing with standby data.

Exits: north, south.

>use medbay terminal
The terminal flickers to life as you access it. Medical data scrolls across the screen.

Available options:
- view crew status
- view sleep data

>view crew data
I didn't understand that sentence.

>view sleep data
Sleep Cycle Data:

REM cycles inconsistent across all crew.
Sleep interruptions recorded at irregular intervals.

Deeper diagnostic data available.

* * *

>use medbay terminal
You can't see any such thing.

>n
Cargo Hold
Tall cargo racks stand silent in the half-light. Most are empty, but a single reinforced container remains secured near the centre of the hold. Thick conduits run from its base into the deck.

Exits: north, south.

* * *

>n
Medbay
A compact medical bay with a diagnostic bed, wall cabinets, and a dark terminal waiting for power.

Exits: north, south.

>x console
You can't see any such thing.

>x terminal
The terminal is dark and unresponsive under emergency power.

>use medbay terminal
The terminal is dark and unresponsive under emergency power.

>view crew status
The medbay terminal is still dark under emergency power.

>view sleep data
The medbay terminal is still dark under emergency power.

>view diagnostic data
The medbay terminal is still dark under emergency power.

* * *

>s
Storage Bay
Metal shelves line the walls, holding maintenance equipment, spare components, and sealed utility cases.

Exits: north, south.

I beg your pardon?

>s
Engineering
Tools drift where they were left, and the smell of machine oil still clings to the air. The engineering consoles are dark except for a faint amber status light.

Exits: north, south.

* * *

>x terminal
The terminal flickers to life as you access it. Medical data scrolls across the screen.

Available options:
- view crew status
- view sleep data

>use medbay terminal
The terminal flickers to life as you access it. Medical data scrolls across the screen.

Available options:
- view crew status
- view sleep data

>access medbay terminal
The terminal flickers to life as you access it. Medical data scrolls across the screen.

Available options:
- view crew status
- view sleep data

>view crew status
Crew Status Summary:

All crew members show elevated stress indicators.
Sleep efficiency below recommended levels.
No physical abnormalities detected.

>view diagnostic data
You should review the sleep data first.

>view sleep data
Sleep Cycle Data:

REM cycles inconsistent across all crew.
Sleep interruptions recorded at irregular intervals.

Deeper diagnostic data available.

* * *

>view sleep data
You need to be at the medbay terminal to do that.

>n
Cargo Hold
Tall cargo racks stand silent in the half-light. Most are empty, but a single reinforced container remains secured near the centre of the hold. Thick conduits run from its base into the deck.

Exits: north, south.

* * *

>n
Medbay
A compact medical bay with a diagnostic bed, wall cabinets, and a dark terminal waiting for power.

Exits: north, south.

>view sleep data
The medbay terminal is still dark under emergency power.

* * *

>view diagnostic data
The medbay terminal is still dark under emergency power.

>view crew satus
I didn't understand that sentence.

>view crew status
The medbay terminal is still dark under emergency power.

>s
Main Corridor
A narrow central corridor runs through the heart of the ship. Under emergency power, only a few weak lights remain active.

Exits: north, south, east, west.

* * *

>n
Engineering
Engineering is fully lit now. Diagnostic panels glow across the walls, and the consoles hum quietly with restored power.

Exits: north, south.

I beg your pardon?

>n
Storage Bay
Bright storage lights reveal neatly secured tools, maintenance kits, and spare components strapped into their wall racks.

Exits: north, south.

* * *

>n
Medbay
Soft white medical lights fill the bay. The diagnostic bed sits beneath a now-active terminal, its screen glowing with standby data.

Exits: north, south.

>view sleep data
Sleep Cycle Data:

REM cycles inconsistent across all crew.
Sleep interruptions recorded at irregular intervals.

Deeper diagnostic data available.

>view crew status
Crew Status Summary:

All crew members show elevated stress indicators.
Sleep efficiency below recommended levels.
No physical abnormalities detected.

>view diagnostic data
Accessing raw medical datasets...

Dataset: Human_Response_Test_A
Dataset: Sleep_Cycle_Adjustment_03
Dataset: Environmental_Variable_Trial

One dataset remains active.

* * *

>view sleep data
You need to be at the medbay terminal to do that.

>view diagnostic data
You need to be at the medbay terminal to do that.

>n
Cargo Hold
Tall cargo racks stand silent in the half-light. Most are empty, but a single reinforced container remains secured near the centre of the hold. Thick conduits run from its base into the deck.

Exits: north, south.

* * *

>n
Engineering
Tools drift where they were left, and the smell of machine oil still clings to the air. The engineering consoles are dark except for a faint amber status light.

Exits: north, south.

I beg your pardon?

I beg your pardon?

>n
Storage Bay
Metal shelves line the walls, holding maintenance equipment, spare components, and sealed utility cases.

Exits: north, south.

* * *

>n
Medbay
A compact medical bay with a diagnostic bed, wall cabinets, and a dark terminal waiting for power.

Exits: north, south.

>view sleep data
Sleep Cycle Data:

REM cycles inconsistent across all crew.
Sleep interruptions recorded at irregular intervals.

Deeper diagnostic data available.

* * *

>x lockers
A row of emergency EVA suit lockers is built into the wall. Most of them hang open and empty. Whatever happened here, the crew took the suits with them.

>north
Cargo Hold
Tall cargo racks stand silent in the half-light. Most are empty, but a single reinforced container remains secured near the centre of the hold. Thick conduits run from its base into the deck.

Exits: north, south.

* * *

>x container
A heavy cargo container, bolted to the deck and wired into the ship through thick power conduits. Its surface is marked with a faded Helios Systems Research Division seal.

>open container
The reinforced container is locked down by heavy clamps.

>n
Reactor Control
Banks of dark control panels surround the reactor monitoring station. Only a small emergency display still glows.

Exits: north, south.

>x console
The main reactor control console. Most systems are offline, but manual controls are still accessible.

>n
Engineering
Tools drift where they were left, and the smell of machine oil still clings to the air. The engineering consoles are dark except for a faint amber status light.

Exits: north, south.

>x console
A dark control console with a few faint amber indicators still glowing under emergency power.

>n
Storage Bay
Metal shelves line the walls, holding maintenance equipment, spare components, and sealed utility cases.

Exits: north, south.

* * *

>e
Captain's Cabin
A private cabin, sparse but orderly. A desk terminal is mounted to the far wall beside a secured storage drawer.

Exits: west.

>x terminal
A private command terminal set into the captain's desk. The screen is dark, awaiting input.

>w
Main Corridor
A narrow central corridor runs through the heart of the ship. Under emergency power, only a few weak lights remain active.

Exits: north, south, east, west.

>w
Crew Quarters
Rows of bunks and small personal lockers fill the cramped living space. Blankets drift loose where they were abandoned in a hurry.

Exits: east.

>x terminal
You can't see any such thing.

>e
Main Corridor
A narrow central corridor runs through the heart of the ship. Under emergency power, only a few weak lights remain active.

Exits: north, south, east, west.

>n
Medbay
A compact medical bay with a diagnostic bed, wall cabinets, and a dark terminal waiting for power.

Exits: north, south.

>x terminal
A compact medical terminal mounted beside the diagnostic bed. Its screen is dark, but a standby light pulses faintly.

>n
Navigation Console
A secondary control station sits here, surrounded by dormant screens and a silent communications panel.

Exits: north, south.

>x console
You can't see any such thing.

>x panels
Dark navigation panels surround the console, their displays inactive under emergency power.

>x comms
A communications panel used to transmit long-range signals. It appears offline.

>n
Bridge
The command bridge is still and dark. Through the forward viewing port, the stars hang cold and motionless.

Exits: south.

>x console
The main command console of the ship. It is currently unpowered.

>xviewscreen
That's not a verb I recognise.

>x viewscreen
Through the forward viewing port, the stars hang cold and motionless.

>s
Navigation Console
A secondary control station sits here, surrounded by dormant screens and a silent communications panel.

Exits: north, south.

* * *

>s
Reactor Control
Banks of dark control panels surround the reactor monitoring station. Only a small emergency display still glows.

Exits: north, south.

>turn on power
You can't see any such thing.

>turn on console
You engage the reactor controls. For a moment, nothing happens. Then a deep hum builds beneath your feet as power flows back into the ship. Lights flicker on throughout the corridors.

Reactor Control
The reactor monitoring panels are alive with light now, feeding a steady stream of system data across their screens.

Exits: north, south.

* * *

>n
Main Corridor
The corridor is fully lit now, revealing scuffed deck plating, handholds along the walls, and the worn signs of long use.

Exits: north, south, east, west.

>a
That's not a verb I recognise.

>e
Captain's Cabin
The captain's cabin is now fully lit, revealing an orderly private space. The desk terminal glows faintly, waiting for input beside a secured storage drawer.

Exits: west.

>w
Main Corridor
The corridor is fully lit now, revealing scuffed deck plating, handholds along the walls, and the worn signs of long use.

Exits: north, south, east, west.

>w
Crew Quarters
Full lighting reveals the cramped quarters in stark detail: unmade bunks, unsecured personal items, and drifting blankets left behind in haste.

Exits: east.

>e
Main Corridor
The corridor is fully lit now, revealing scuffed deck plating, handholds along the walls, and the worn signs of long use.

Exits: north, south, east, west.

>n
Medbay
Soft white medical lights fill the bay. The diagnostic bed sits beneath a now-active terminal, its screen glowing with standby data.

Exits: north, south.

* * *

>s
Navigation Console
The navigation station glows with restored power. Course data, comms status, and telemetry scroll quietly across the active displays.

Exits: north, south.

>s
Medbay
Soft white medical lights fill the bay. The diagnostic bed sits beneath a now-active terminal, its screen glowing with standby data.

Exits: north, south.

I beg your pardon?

>s
Main Corridor
The corridor is fully lit now, revealing scuffed deck plating, handholds along the walls, and the worn signs of long use.

Exits: north, south, east, west.

>s
Storage Bay
Bright storage lights reveal neatly secured tools, maintenance kits, and spare components strapped into their wall racks.

Exits: north, south.

* * *

>s
Engineering
Engineering is fully lit now. Diagnostic panels glow across the walls, and the consoles hum quietly with restored power.

Exits: north, south.

>s
Reactor Control
The reactor monitoring panels are alive with light now, feeding a steady stream of system data across their screens.

Exits: north, south.

>s
Cargo Hold
The cargo hold is washed in cold industrial light. Empty racks cast long shadows across the deck, while the reinforced container sits under a steady glow, its power conduits clearly visible now.

Exits: north, south.

* * *

>north
Reactor Control
Banks of dark control panels surround the reactor monitoring station. Only a small emergency display still glows.

Exits: north, south.

>x console
The main reactor control console. Most systems are offline, but manual controls are still accessible.

>turn on console
You engage the reactor controls. For a moment, nothing happens. Then a deep hum builds beneath your feet as power flows back into the ship. Lights flicker on throughout the corridors.

>north
Engineering
Tools drift where they were left, and the smell of machine oil still clings to the air. The engineering consoles are dark except for a faint amber status light.

Exits: north, south.

>x console
A dark control console with a few faint amber indicators still glowing under emergency power.

>north
Storage Bay
Metal shelves line the walls, holding maintenance equipment, spare components, and sealed utility cases.

Exits: north, south.

>x cases
You can't see any such thing.

>north
Main Corridor
A narrow central corridor runs through the heart of the ship. Under emergency power, only a few weak lights remain active.

Exits: north, south, east, west.

>east
Captain's Cabin
A private cabin, sparse but orderly. A desk terminal is mounted to the far wall beside a secured storage drawer.

Exits: west.

>x terminal
A private command terminal set into the captain's desk. The screen is dark, awaiting input.

* * *

>w
Crew Quarters
Rows of bunks and small personal lockers fill the cramped living space. Blankets drift loose where they were abandoned in a hurry.

Exits: east.

>e
Main Corridor
A narrow central corridor runs through the heart of the ship. Under emergency power, only a few weak lights remain active.

Exits: north, south, east, west.

* * *

>x scratched warning
You can't make anything out in the darkness.

>n
Cargo Hold
Tall cargo racks stand silent in the half-light. Most are empty, but a single reinforced container remains secured near the centre of the hold. Thick conduits run from its base into the deck.

Exits: north, south.

* * *

>s
Airlock
Bright overhead lights reveal every scrape and dent in the chamber. Several EVA suit lockers stand open along one wall, most of them empty. Deep scratches have been carved into the metal beside the outer hatch: "DON'T LET IT HEAR YOU".

Exits: north.

>x scratched warning
The words are carved deep into the metal:

"DON'T LET IT HEAR YOU"

The cuts are uneven. Desperate.

Someone took the time to leave this behind.

>user door
That's not a verb I recognise.

>use  door
You are not sure how to use the outer airlock door.

>open door
You reach for the control. For a moment, nothing happens.

Then the system responds:

"Access denied."

The message appears before your hand touches the panel.

>open door
You move toward the control again.

The display activates immediately:

"Access denied."

It was waiting this time.